#################.......
####..Z...#######..S....
###.....#########.....##
#####.############..####
#####.############..####
##.............I.....###
###.#####.##############
###.#####.####..Z...####
##..#####.####..########
##..#####......#########
########################
